####################
#N    #           ##
# ##### ##### ### ##
# #         #   # ##
# # ######### # ####
#     #   #   #   ##
# # ### # ### ### ##
# #     # #     #  #
# ### # # ### ### ##
#   # # #   # #   ##
# # # ### ####### ##
# # # # #   #   #  #
### ### ##### ######
#               #  #
### # ####### ### ##
#   #     #       ##
# # # # # # # ### ##
# # # # # # # #    #
##### ###########  #
################## #
